# Gboard Dictionary version:1
あいてぃーじょうほうしょりのそようはこれからのじだいのよみかきそろばん	IT、情報処理の素養はこれからの時代の『読み書きそろばん』	ja-JP
あやってるよ	あ、やってるよ	ja-JP
あいてのいっていることをことさらそうやってきょくかいしてあげあしとりをしようとしているんでしょうけれどもそれもからぶりしていますよもうしわけないけれども	相手の言っていることを殊さらそうやって曲解して、揚げ足取りをしようとしているんでしょうけれども、それも空振りしていますよ、申しわけないけれども。	ja-JP
あいてをひぼうちゅうしょうしたってなにもうまれないんです	相手を誹謗中傷したって何も生まれないんです	ja-JP
あくむのようなみんしゅとうせいけん	悪夢のような民主党政権	ja-JP
あさどせいけんはみちをゆずるべきだ	アサド政権は道を譲るべきだ	ja-JP
あなたがそうりになってからやればいいじゃないか	あなたが総理になってからやればいいじゃないか	ja-JP
あさひらしいあくいとねつぞうにみちたでっちあげきじです	朝日らしい、悪意と捏造に満ちたデッチ上げ記事です	ja-JP
あべさんきゅうりょうがあがったからはっぽうしゅがびーるにかわったんだよ	安倍さん給料が上がったから発泡酒がビールに変わったんだよ	ja-JP
あべしんぞう	安倍晋三	ja-JP
あべしんぞうをおとしめようということならやめたほうがいい	安倍晋三を貶めようということならやめたほうがいい	ja-JP
あべせいけんはかねまみれだとこれとんでもないきめつけでありますよ	安倍政権は"カネまみれ"だとこれとんでもない決めつけでありますよ	ja-JP
あべのみくすはしっぱいだった	アベノミクスは失敗だった	ja-JP
あそこはまさにぎゅっとこうしまっていまして	あそこはまさにぎゅっとこう絞まっていまして	ja-JP
あのみずじゃなくちゃぜったいだめなんだ	あの水じゃなくちゃ、絶対ダメなんだ！	ja-JP
あまくなりました	甘くなりました	ja-JP
あまりにもいいんがこうふんされるからこういうのはしっかりとおちついたぎろんをしましょうよ	あまりにも委員が興奮されるからこういうのはしっかりと落ち着いた議論をしましょうよ	ja-JP
あわれですねあさひらしいみじめないいわけよそうどおりでした	哀れですね。朝日らしい惨めな言い訳。予想通りでした。	ja-JP
ありがとうげんきでね	ありがとう げんきでね	ja-JP
あれはひとりごとだったんですがひとりごとがおおきくなった	あれは独り言だったんですが、独り言が大きくなった	ja-JP
あんだーこんとろーる	アンダーコントロール	ja-JP
いいかげんなことばっかりいうんじゃないよ	いい加減なことばっかり言うんじゃないよ	ja-JP
はんろんさせろよちょっと	反論させろよ、ちょっと。	ja-JP
いいのかよそれだったら	いいのかよそれだったら	ja-JP
いいんだよそんなことすいせんしたってじゅしょうできるかわからないしじゅしょうしたらしたでたかくうれるじゃないか	いいんだよ、そんなこと。推薦したって受賞できるか分からないし、受賞したらしたで高く売れるじゃないか	ja-JP
いけあべしんぞう	行け、安倍晋三	ja-JP
いしばほんにんといしばについたぎいんはてっていしてほしあげる	石破本人と石破についた議員は徹底して干し上げる	ja-JP
いせつさきとなるほんどのりかいがえられない	移設先となる本土の理解が得られない	ja-JP
いちぶのくにそしてみんぞくやぶんかをはいじょしようというあるいはぞうおをあおるようなかげきなげんどうはけっしてあってはならない	一部の国そして民族や文化を排除しようというあるいは憎悪を煽るような過激な言動は決してあってはならない	ja-JP
いちぶのひとだけにとみがあつまるあるいはむほうものがとくをするじょうたいをつくってはなりません	一部の人だけに富が集まるあるいは無法者が得をする状態をつくってはなりません	ja-JP
いっしゅんぜっちょうきをむかえてたかびしゃなたいどになってしまったのですかね	一瞬、絶頂期を迎えて、高飛車な態度になってしまったのですかね	ja-JP
いっしょうけんめいおとしめようとしているそのどりょくはみとめますよ	一生懸命貶めようとしているその努力は認めますよ	ja-JP
いってきます	行ってきます	ja-JP
いっぱいいるよ	いっぱいいるよ	ja-JP
いっぱんかいけいのぷらいまりーばらんすもかいざんさせております	一般会計のプライマリーバランスも改ざんさせております	ja-JP
いっぱんしゃだんほうじんこらぼはたいへんじゅうようなかつどうをされているとかんがえています	一般社団法人Colaboは、大変重要な活動をされていると考えています	ja-JP
いっぽんをとりもろす	イッポンを、トリモロス	ja-JP
いっぽうてきになまえがだされわたしはたいへんとうわくをいたしております	一方的に名前が出され私は大変当惑をいたしております	ja-JP
いつまでつづくのかこのいらだちとふあん	いつまで続くのか、この苛立ちと不安	ja-JP
いとうひろふみはたたみのうえでしにたくないといっていた	伊藤博文は畳の上で死にたくないと言っていた	ja-JP
いみのないしつもんだよ	意味のない質問だよ	ja-JP
いやおれもつかれるんだよ	いやオレも疲れるんだよ	ja-JP
いやせきにんがあるからせきにんをわたしのわたしのせきにんをとると	いや責任があるから責任を私の私の責任を取ると…	ja-JP
いわばまさに	いわばまさに	ja-JP
いんたねっとはじゆうなくうかんです	インターネットは、自由な空間です	ja-JP
いんぺいというのはですねいんぺいというのはいんぺいというのはじゃあわたくしがいんぺいしたんですか	隠蔽というのはですね、隠蔽というのはー、隠蔽というのはじゃあ、わたくしが隠蔽したんですか	ja-JP
うぃんうぃん	ウィンウィン	ja-JP
うにについてはごういしましたよ	ウニについては合意しましたよ	ja-JP
うみをだしきる	膿を出し切る	ja-JP
うらぎりものはぜったいにゆるさない	裏切り者は絶対に許さない！	ja-JP
うらじみるくんとぼくはおなじみらいをみている	ウラジーミル、君と僕は同じ未来を見ている	ja-JP
ふたりのちからでかけてかけかけぬけようではありませんか	二人の力で駆けて、駆け、駆け抜けようではありませんか	ja-JP
うつくしいほしごぜろ	美しい星50	ja-JP
えまとんぷそんえまわとそん	エマ・トンプソン（エマ・ワトソン）	ja-JP
えんがさんぜろぜろえんになったらあっというまにけいざいはかいふくしていくというかんがえはどうか	円が300円になったらあっという間に経済は回復していくという考えはどうか	ja-JP
えんげるけいすうじょうしょうはしょくせいかつのへんかによるものです	エンゲル係数上昇は食生活の変化によるものです	ja-JP
おいわいはどこでやるの	お祝いはどこでやるの	ja-JP
おうえんするよじょせいはつのそうりだいじんいいじゃないか	応援するよ。女性初の総理大臣、いいじゃないか	ja-JP
おおおお	おお、おお！	ja-JP
おおげさだよ	大げさだよ	ja-JP
おかしいよ	おかしいよ	ja-JP
おとがうるさくてねちょっとねおとがうるさいんだけどええ	音がうるさくてね。ちょっとね音がうるさいんだけど。ええ。	ja-JP
おとうさんけんぽういはんなのといわれたじえいかんすらいます	「お父さん、憲法違反なの」と言われた自衛官すらいます	ja-JP
わたしがいっていることうそだっていっているんでしょうそれ	私が言っていること、嘘だって言っているんでしょうそれ	ja-JP
おとうさんもこいびとをさそっておかあさんはむかしのこいびとをさがしだしてとうひょうばこにあしをはこんでください	お父さんも恋人を誘って、お母さんは昔の恋人を探し出して投票箱に足を運んでください	ja-JP
おなじあべでもずいぶんちがいますね	同じアベでもずいぶん違いますね	ja-JP
おぼえてろつぎはおまえらをたおしてやる	覚えてろ、次はお前らを倒してやる	ja-JP
おまえもたまにはいちかいくらいざせつしとけよそのほうがひとかわむけておおきなせいじかになれるよ	お前もたまには1回くらい挫折しとけよ。そのほうが一皮むけて大きな政治家になれるよ	ja-JP
おれだってほんとうはへいわがすきなんだよ	オレだって、本当は平和が好きなんだよ	ja-JP
おんしゃのねっとでもぬのますくさんさんぜろぜろえんではんばいをしておられたということはしょうちをしております	御社のネットでも布マスク3300円で販売をしておられたということは承知をしております	ja-JP
おとうのつじもとぎいんにもおなじことがおこっているじゃないですか	御党の辻元議員にも同じことが起こっているじゃないですか	ja-JP
かいかくじっこうりょくがあるのはわたしたちじみんとうとそしてみんしゅとうであります	改革実行力があるのは私たち自民党と、そして民主党であります	ja-JP
がいこうこうしょうはねすがったらおわりなんですだんじょのかんけいもそうですからね	外交交渉はね、すがったら終わりなんです、男女の関係もそうですからね。	ja-JP
がいこくからぜったいにえいきょうをうけてはならない	外国から絶対に影響を受けてはならない	ja-JP
がいちてき	ガイチテキ	ja-JP
かきくえばならのまち	柿くえば ◯◯◯◯◯◯◯ 奈良のまち」	ja-JP
かくぎけってい	閣議決定	ja-JP
かくさなんていつのじだいでもあるじゃああさひしんぶんのきゅうりょうはいくらなんですか	格差なんていつの時代でもある、じゃあ朝日新聞の給料はいくらなんですか	ja-JP
かこをふりかえってもあるいはまえせいけんをひはんしてもいまげんざいわたしたちがちょくめんをしているききかだいがかいけつされるわけではありません	過去を振り返っても、あるいは前政権を批判しても、今現在、私たちが直面をしている危機、課題が解決されるわけではありません	ja-JP
かつかれがさんごぜろぜろえんするこうきゅうひんだとひはんしたしんぶんしゃのかつかれはごぜろぜろぜろえんをこえているとねっとでながれていたじだいはかわったとかんじる	カツカレーが3500円する高級品だと批判した新聞社のカツカレーは5000円を超えているとネットで流れていた。時代は変わったと感じる	ja-JP
がっこうでみなからあべべとよばれていたんですよ	学校で皆からアベベと呼ばれていたんですよ	ja-JP
かつてかつてにせめるかつてにせめるじけんがありましたねかつてにせめるじけんというのがあった	かつて、かつて偽メール、かつて偽メール事件がありましたね。かつて偽メール事件というのがあった。	ja-JP
かていのしつもんにはおこたえすることはできない	仮定の質問にはお答えすることはできない	ja-JP
きんはいくらでもだすかんぼうきみつひもあるから	金はいくらでも出す。官房機密費もあるから	ja-JP
かならずかちとれ	必ず勝ち取れ	ja-JP
かはんすうがあればそれはふるちんになっていく	過半数があれば、それはﾌﾙﾁﾝになっていく	ja-JP
かぶかぶがあがりますように	カブ（株）が上がりますように	ja-JP
かやまりかしはろんがい	香山リカしは論外	ja-JP
かれこそほんとうのいうだけばんちょうなのだけど	彼こそ本当の『言うだけ番長』なのだけど	ja-JP
かれはきょうれつなりありすとなのです	彼は強烈なリアリストなのです	ja-JP
かりにじぶんがのぞまれるならしぜんときうんがたかまりわたしにたいするねっきがいっきにたかまるはずだ	仮に自分が望まれるなら、自然と機運が高まり、私に対する熱気が一気に高まるはずだ	ja-JP
かんぐれおまえ	勘ぐれ、お前	ja-JP
かんさんはれきだいしゅしょうにいれないことにきめたからかんさんはいらないよ	菅さんは（歴代首相に）入れないことに決めたから、菅さんは入らないよ	ja-JP
かんぜんにぶろっく	完全にブロック	ja-JP
かんたんだったすごくかんたん	簡単だった すごく簡単	ja-JP
きいているようにみえてぜんぜんきいてないんだよね	聞いているように見えて、全然聞いてないんだよね	ja-JP
きしださんはこわいにんだよじぶんにもたにんにもいたみをかんじないらくたんもしないからぜったいにあきらめない	岸田さんは怖い人だよ。自分にも他人にも、痛みを感じない。落胆もしないから、絶対に諦めない	ja-JP
きみじゃなくてよかったよ	キミじゃなくてよかったよ	ja-JP
くんはあべのみくすをひはんするのか	君はアベノミクスを批判するのか？	ja-JP
きょうさんとう	共産党！	ja-JP
ぎろんはいよいよにつまってきている	議論はいよいよ煮詰まってきている	ja-JP
きわめてまぬけなぎいん	きわめてマヌケな議員	ja-JP
きわめてわたしはふゆかいですよきわめてわたしはふゆかいなんです	極めて私は不愉快ですよ極めて私は不愉快なんです	ja-JP
きをつけようあまいことばとみんしんとう	気をつけよう、甘い言葉と民進党	ja-JP
きをひきしめていきます	気を引き締めていきます	ja-JP
きんゆうちょうはだいばかものだなこんなことをかいて	金融庁は大バカ者だな。こんなことを書いて	ja-JP
くだらないしつもんでおわっちゃったねまた	くだらない質問で終わっちゃったね、また	ja-JP
くにがめちゃくちゃになる	国がめちゃくちゃになる	ja-JP
くらくらする	クラクラする	ja-JP
くるくるまわしてちからづよくまわしてまえにすすんでいくひつようがある	くるくる回して力強く回して前に進んでいく必要がある	ja-JP
けいいかんしゃきずなあればういるすこくふくできる	敬意・感謝・絆あればウイルス克服できる	ja-JP
けいきかいふくこのみちしかない	景気回復、この道しかない	ja-JP
けっこうでございましたげんきがでてくるようだ	結構でございました。元気が出てくるようだ	ja-JP
かねやまのはまぐりはとさのうみにていちゃくしました	兼山のハマグリは土佐の海に定着しました	ja-JP
けんこうしょくひんのきのうせいひょうじをかいきんいたします	健康食品の機能性表示を解禁いたします	ja-JP
げんこうにはざんねんながらやまぐちけんのぶっさんがかいていないよくそんたくしてほしい	原稿には残念ながら山口県の物産が書いていない。よく忖度してほしい	ja-JP
けんさかずふえればかんせんしゃのぜったいすうふえるかのうせいある	検査数増えれば、感染者の絶対数増える可能性ある	ja-JP
げんばもいっしょうけんめいきょにゅう	現場も一生懸命、巨乳	ja-JP
けんりょくはがんがんがんがんつかうものなんですよ	権力はガンガンガンガン使うものなんですよ	ja-JP
けんぽうについてかんがえかたのひとつとしていわばこっかけんりょくをしばるものだというかんがえかたはありますがしかしそれはかつておうけんがぜったいけんりょくをもっていたじだいのしゅりゅうてきなかんがえかた	憲法について、考え方の一つとして、いわば国家権力を縛るものだという考え方はありますが、しかし、それはかつて王権が絶対権力を持っていた時代の主流的な考え方	ja-JP
こいけさんはつねにじょかです	小池さんは、常にジョーカーです	ja-JP
こいずみさんはいいんだよがいこうのせんすがすごくあるのだ	小泉さんはいいんだよ。外交のセンスがすごくあるのだ	ja-JP
こうごきたいです	乞うご期待です	ja-JP
ここでみずをのむ	(ここで水を飲む)	ja-JP
こくみんのいかめしいめがそそがれていることをじゅうぶんにいしきしながらじじつにもとづきていねいなうえにもていねいなせつめいをしていくどりょくをおもねていきたい	国民の厳しい目が注がれていることを十分に意識しながら、事実に基づき、丁寧な上にも丁寧な説明をしていく努力を重ねていきたい	ja-JP
こっかいとうべんであくむのようなみんしゅとうといったことはない	国会答弁で悪夢のような民主党と言ったことはない	ja-JP
こどもがうまれたのにほけんしょにあずけられない	子供が生まれたのに保健所に預けられない	ja-JP
このあまさをとりながらすとれすをかいしょうする	この甘さをとりながら、ストレスを解消する	ja-JP
このこころがまえがそんなにおかしんでしょうかねみなさん	この心構えがそんなにおかしんでしょうかね、皆さん	ja-JP
このてんのにんしきをぺきんのひとびとはとりわけしゅうきんぺいしゅせきはだんじてけんあやまるべきではありません	この点の認識を北京の人々はとりわけ習近平主席は断じて見誤るべきではありません	ja-JP
このねくたいだいじにする	このネクタイ大事にする	ja-JP
このようにりようされるのはさいしょからわかりきったこと	このように利用されるのは最初から分かりきったこと	ja-JP
ごめしがほっしくなるね	ご飯が欲しくなるね	ja-JP
こめもひとつひとつがたっててかがやいて	米も一つひとつが立ってて、輝いて	ja-JP
これいくらかっていこうかな	これいくら？買っていこうかな	ja-JP
これからとらんぷだいとうりょうをおむかえします	これから、トランプ大統領をお迎えします！	ja-JP
これからのながいじんせいしっぱいはつきものなんかいもしっぱいするかもしれないたいせつなことはそこからたちあがることそしてしっぱいからまなべればもっとすばらしい	これからの長い人生、失敗はつきもの。何回も失敗するかもしれない。大切なことはそこから立ち上がること。そして失敗から学べれば、もっとすばらしい	ja-JP
これでわたしもおわりかもしれないね	これで私も終わりかもしれないね	ja-JP
これにははんのうしません	これには反応しません	ja-JP
これはいったいなになんだとおもうわけでして	これは一体何なんだと思うわけでして	ja-JP
これはいんちきなんですよ	これはインチキなんですよ	ja-JP
これはずいぶんからくちだ	これは随分 辛口だ	ja-JP
これはとうどのたいへんたかいとまと	これは糖度の大変高い（トマト）	ja-JP
これはちょっとさんびょうくらいかんがえればわかることだとおもいますよ	これはちょっと3秒くらい考えればわかることだと思いますよ	ja-JP
これはですねまちのこえですからみなさんえらんでいるとおもいますよもしかしたらね	これはですね、街の声ですから。みなさん選んでいると思いますよ、もしかしたらね	ja-JP
これはなにがかいてあるのかな	これは何が書いてあるのかな？	ja-JP
これはぽるぽとやすたりんがおこなおうとしたことです	これはポル・ポトやスターリンが行おうとしたことです	ja-JP
これはほんとうにまあぼうそうしてるとおもうねじぇんだふりなちずむみたいな	これは本当にまあ暴走してると思うね ジェンダーフリーナチズムみたいな	ja-JP
ごるふはだめでですねてにすはいいのかしょうぎははいいのかということなんだろうとおもいますよ	ゴルフは駄目でですね、テニスはいいのか、将棋ははいいのか、ということなんだろうと思いますよ	ja-JP
こんきょのないことをいうのはうそをつくのとおなじですよ	根拠のないことを言うのは嘘をつくのと同じですよ	ja-JP
こんごともわたしがせんとうにたちどりるのはとなってあらゆるがんばんきせいをうちやぶっていくけついだ	今後とも私が先頭に立ちドリルの刃となってあらゆる岩盤規制を打ち破っていく決意だ	ja-JP
こんなぎろんをやってたんじゃなんじかんやったっておなじですよ	こんな議論をやってたんじゃ何時間やったって同じですよ	ja-JP
こんなのとうしちゃだめだよ	こんなの通しちゃ駄目だよ	ja-JP
こんなひとたちにまけるわけにはいかない	こんな人達に負けるわけにはいかない！	ja-JP
さぁばっ	サァバッ	ja-JP
さいきょうのだいさんしゃきかんといわれるこのけんさつがしっかりとそうさをしたけっかがもうすでにでている	最強の第三者機関と言われるこの検察がしっかりと捜査をした結果がもう既に出ている	ja-JP
さいきんがっかいかんぶからしんちょうにこうどうするようにいわれおそろしいだんたいだとおもった	最近、学会幹部から慎重に行動するように言われ、恐ろしい団体だと思った	ja-JP
さいはんぼうし	再犯防止	ja-JP
さくらだだいじんにおいてはもんぶかがくふくだいじんとしておりんぴっくしょうちにたいへんごじんりょくしたひとりでございまして	櫻田大臣においては、文部科学副大臣としてオリンピック招致に大変御尽力した一人でございまして	ja-JP
さりんをだんとうにつけてちゃくだんさせるというのうりょくについてはすでにきたちょうせんはほゆうしているかのうせいがある	サリンを弾頭に付けて着弾させるという能力については既に北朝鮮は保有している可能性がある	ja-JP
てぃーえいちえーえぬけーわいおーゆーぶいいーあーるわいえむゆーしーえいち	Thank you very much.	ja-JP
さんかくにのしゅのうはさんごくじだいのぎくれしょくではなくそうあらそうものどうしではない	3カ国の首脳は三国時代の「魏」「呉」「蜀」ではなく相争う者どうしではない	ja-JP
さんごはたいせつに	珊瑚は大切に。	ja-JP
ねんじゅみょうがのびたね	３・５年（寿命が）延びたね	ja-JP
ざんきにこたえないおもいであります	慚愧に堪えない思いであります	ja-JP
みかたよしということになるのではないか	三方よしということになるのではないか	ja-JP
しうんいんでんまつりごとよせいじょうすすむひさしだいこじ	紫雲院殿政誉清浄晋寿大居士	ja-JP
じえいたいのしょくんにあいするかぞくがいることをわたしはしっています	自衛隊の諸君に愛する家族がいることを私は知っています	ja-JP
じえいたいをごうけんかする	自衛隊を合憲化する	ja-JP
じじつじょうろんぱをさせていただいたとおもっている	事実上論破をさせていただいたと思っている	ja-JP
じじつよんぜろぜろぜろぺじこれはみなさんもよんでおられないとおもいます	事実4000ページ、これはみなさんも読んでおられないと思います	ja-JP
じだいをきりひらいていこうとすればときにはつよいふうあつをうけることもありますが	時代を切り開いていこうとすれば、時には強い風圧を受けることもありますが	ja-JP
しっかりとうけつがれていくとわたしはかくしんしております	しっかりと受け継がれていくと私は確信しております	ja-JP
じっさいにこういをいっていたにんかんとくをになっていたにんがせきにんをにんしきしなければいけない	実際に行為を行っていた人、監督を担っていた人が責任を認識しなければいけない	ja-JP
じつによませるいんたびゅでした	実に「読ませるインタビュー」でした	ja-JP
じつむをこなしているのはせいふなんだけれどなあ	実務をこなしているのは、政府なんだけれどなあ	ja-JP
しつれいなやつだ	失礼な奴だ	ja-JP
じみんとうはけっとういらいきょうこうさいけつしようとかんがえたことはない	自民党は結党以来強行採決しようと考えたことはない	ja-JP
じみんとうはろうそうあおじんざいのほうこであります	自民党は老壮青、人材の宝庫であります	ja-JP
じぶんはうそをついてしまったとみとめたほうがいいとおもいますよ	自分は嘘をついてしまったと認めた方がいいと思いますよ	ja-JP
じぶんはごねんでかえりざきましたあなたにもいずれそういうにちがやってきますよ	自分は5年で返り咲きました。あなたにも、いずれそういう日がやって来ますよ	ja-JP
じぶんひとりではんだんをした	自分一人で判断をした	ja-JP
えすえいちあいえぬいー	SHINE！	ja-JP
しゅうかんしがほんとうだったらかめいさんはたいへんなことになってますよ	週刊誌が本当だったら、亀井さんは大変な事になってますよ	ja-JP
いちぜろねんでこくみんのそうしょとくをいちごぜろまんえんふやしてまいります	10年で国民の総所得を150万円増やしてまいります	ja-JP
しゅしょうとはながいつきあいだがいままででもっともおもしろいじょくだ	首相とは長い付き合いだが、今までで最も面白いジョークだ	ja-JP
しゅのうどうしがあくしゅするだけでちいきのへいわにつながる	首脳同士が握手するだけで地域の平和につながる	ja-JP
おものおおみかさますくいしゅさまひじりしゅさまおしえしゅさま	主の大御神様、救い主様、聖珠様、教え主様	ja-JP
しゅんせつにさいしてさらにおおくのちゅうごくのみなさまがほうにちされることをたのしみにしています	春節に際して、更に多くの中国の皆様が訪日されることを楽しみにしています	ja-JP
しょうがいしゃこようのたんじかんきんむしょくいん	障害者雇用の短時間勤務職員	ja-JP
じんどううえのかんてんからしかくをゆうするがいこくじんのほうにはせいかつほごをしきゅうしています	人道上の観点から、資格を有する外国人の方には生活保護を支給しています	ja-JP
しんにゅうしゃいんっていうのはしっぱいするんですよね	新入社員っていうのは失敗するんですよね。	ja-JP
しんらばんしょう	森羅万象	ja-JP
しんりゃくというていぎについてはこれはがっかいてきにもこくさいてきにもさだまっていないといってもいいんだろうとおもうわけでございます	侵略という定義については、これは学界的にも国際的にも定まっていないと言ってもいいんだろうと思うわけでございます	ja-JP
すいぎんによるひがいとそのこくふくをへたわれわれだからこそせかいからすいぎんのひがいをなくすためせんとうにたってちからをつくすせきにんがにっぽんにはある	水銀による被害とその克服を経たわれわれだからこそ、世界から水銀の被害をなくすため、先頭に立って力を尽くす責任が日本にはある	ja-JP
かんちゃんたのむよ	菅ちゃん、頼むよ	ja-JP
かんちゃんちょっとまとめてよ	菅ちゃん、ちょっとまとめてよ	ja-JP
すぎはらあだち	スギハラアダチ	ja-JP
ずぶずぶのかんけいとかいうひんのわるいことば	ずぶずぶの関係とかいう品の悪い言葉	ja-JP
すみませんいいんちょうちょっとそとのほうがうるさくて	すみません委員長ちょっと外の方がうるさくて	ja-JP
せいけんにつごうのいいじょうほういんぺいはおこらない	政権に都合のいい情報隠蔽は起こらない	ja-JP
はいごせいご	背後（せいご）	ja-JP
せいこちゃんとはなんかいもはぐしてるんだけどねいっぱいのんだら	聖子ちゃんとは何回もハグしてるんだけどね。一杯飲んだら	ja-JP
せいこちゃんやってよ	聖子ちゃん、〇〇やってよ	ja-JP
せいさくのしっぱいというがしっぱいではなくてふくしまいいんがせいけんにおられたときよりもにぜろばんにんよんぜろばんにんふやしている	政策の失敗というが、失敗ではなくて、福島委員が政権におられたときよりも20万人、40万人増やしている	ja-JP
せいじせきにんうんぬんというのはりかいできない	政治責任うんぬんというのは理解できない	ja-JP
せいじとおきんのもんだいにこれからこんぽんてきにめすをいれていくことそしてふはいをいかめしくぼうしするほうりつをいっこくもはやくつくること	政治とお金の問題にこれから根本的にメスを入れていくこと そして腐敗を厳しく防止する法律を一刻も早く作ること	ja-JP
せいじはけっかなんですよ	政治は結果なんですよ	ja-JP
せいじはみらいのためにある	政治は未来のためにある	ja-JP
せいちょうかいちょうがせつめいしてくれないとおさまりません	政調会長が説明してくれないと収まりません！	ja-JP
せきにんですかね	責任…ですかね	ja-JP
せんきょでとうせんしなかったからつかまったんだよわらい	選挙で当選しなかったから捕まったんだよ（笑）	ja-JP
せんきょのためならなんでもするだれともくむむせきにんなせいりょくにまけるわけにはいかない	選挙のためなら何でもする 誰とも組む 無責任な勢力に負ける訳にはいかない	ja-JP
ぜいしゅうというのはこくみんからすいあげたものでありまして	税収というのは国民から吸い上げたものでありまして	ja-JP
ぜったいにつかまらないようにします	絶対に捕まらないようにします	ja-JP
ぜんぜんむっとしていないですよただいちかところきになったところがあった	全然、ムッとしていないですよ。ただ1か所、気になったところがあった	ja-JP
せんぱいがごめいわくをおかけしたことをおわびしなければいけない	先輩がご迷惑をおかけしたことをおわびしなければいけない	ja-JP
そういうあたらしいじゅういだいがくのかんがえはいいね	そういう新しい獣医大学の考えはいいね	ja-JP
そういうおやもしどうしなければいけないじだいにもうきているのかなとおもう	そういう親も指導しなければ行けない時代に、もう来ているのかなと思う	ja-JP
そういうこどもっぽいことはやめましょうよ	そういう子供っぽいことはやめましょうよ	ja-JP
そうとうくわしくよみうりしんぶんにかいてありますから	相当詳しく読売新聞に書いてありますから	ja-JP
そうやっていんしょうそうさをいっしょうけんめいされていますけれどもいっしょうけんめいいっしょうけんめいそうやっていっしょうけんめいいんしょうそうさをされていますけれども	そうやって印象操作を一生懸命されていますけれども、一生懸命、一生懸命、そうやって一生懸命印象操作をされていますけれども	ja-JP
そうりだいじんとしてじじつをのべてはならないということではないんだろう	総理大臣として事実を述べてはならないということではないんだろう	ja-JP
そうりだいじんなのでしんらばんしょうすべてたんとうしていますから	総理大臣なので森羅万象全て担当していますから	ja-JP
そこでおいしいおいしいよぐるとになりたいとおもう	そこでおいしいおいしいヨーグルトになりたいと思う	ja-JP
そとにだすことをぜんていにしていないはつげん	外に出すことを前提にしていない発言	ja-JP
そのしりょうはなんだよ	その資料はなんだよ	ja-JP
そのときしゃかいはあたかもりせっとぼたんをおしたようになってにっぽんのけしきはいっぺんするでしょう	そのとき社会はあたかもリセット・ボタンを押したようになって、日本の景色は一変するでしょう	ja-JP
そのほっぽうりょうどについてはのしまにはわがくにがしゅけんほっぽうりょうどのしまはわがくにがしゅけんをゆうするしまであるというたちばでございます	その北方領土については、の島々には、我が国が主権、北方領土の島々は我が国が主権を有する島々であるという立場でございます。	ja-JP
そもそもということばのいみについてじしょでねんのためにしらべてみたわけでありますがこれはきほんてきにといういみもある	『そもそも』という言葉の意味について、辞書で念のために調べてみたわけでありますが、これは『基本的に』という意味もある	ja-JP
それはいんふれがどんどんすすんでいくというもんだいもういちてんはえんのかちがどんどんぼうらくしていくというもんだい	それはインフレがどんどん進んでいくという問題、もう1点は円の価値がどんどん暴落していくという問題。	ja-JP
それはわたしのじむしょにかかわることでありますからたんとうするだいじんからとうべんさせたいとおもいます	それは私の事務所に関わることでありますから、担当する大臣から答弁させたいと思います	ja-JP
そんなことできるはずがないじゃないですか	そんなことできるはずがないじゃないですか	ja-JP
そんなことよりいちどはりそうのじょうしとかかれてみたいものであります	そんなことより、一度は理想の上司と書かれてみたいものであります	ja-JP
そんなにこうふんしないでください	そんなに興奮しないでください	ja-JP
だいじょうぶだからわたしをしんじてついてこなさい	大丈夫だから、私を信じてついて来なさい	ja-JP
だいたいほんとうにわるだくみをしようとしたらそんなしゃしんなんかだしませんよ	大体本当に悪巧みをしようとしたらそんな写真なんか出しませんよ	ja-JP
だいひょうなくしてかぜいなし	代表なくして課税なし	ja-JP
たいへんもうそうをたくましくしておられますがそんなじじつはまったくありません	大変、妄想をたくましくしておられますが、そんな事実は全くありません	ja-JP
たいりょうはかいへいきがないとしょうめいできなかったいらくがわるい	大量破壊兵器がないと証明できなかったイラクが悪い	ja-JP
たいわんのだいこんもだいぶうんちにちかいよね	台湾の大根もだいぶウンチに近いよね	ja-JP
たかいちさなえをおうえんしない	高市早苗を応援しない	ja-JP
たかいちさんねふうふべつしあれはだめだよ	高市さんね、夫婦別氏、あれはダメだよ	ja-JP
たかいりんりかんをもて	高い倫理観を持て	ja-JP
だからすみませんっていってるじゃないか	だから、すみませんって言ってるじゃないか	ja-JP
だからなんだってんだ	だから何だってんだ	ja-JP
だすべきときはだすべきだ	出すべきときは出すべきだ	ja-JP
だってここれにかいこれにかきこれにこれにかいてないじゃないですか	だって、こ、これに、書い、これに書……これに、これに書いてないじゃないですか？	ja-JP
だれかにもらったんだよ	誰かにもらったんだよ	ja-JP
たる	タル	ja-JP
ちなみにですねみんしゅとうせいけんしたのさんねんかんは	ちなみにですね民主党政権下の三年間は	ja-JP
ちゅうごくはながきにわたりにっぽんのおてほんでした	中国は長きにわたり日本のお手本でした	ja-JP
ちょぜばいたきます	チョーゼバ、イターキマス	ja-JP
おはしくるんっ	（お箸クルンッ)	ja-JP
ちょっといかんだった	ちょっと遺憾だった	ja-JP
ちょっとといれいってきていい	ちょっとトイレ行ってきていい？	ja-JP
ちんあげのはながまいちるはるのかぜ	賃上げの花が舞い散る春の風	ja-JP
つぎはかんさんとやりあってくださいよ	次は菅さんとやり合ってくださいよ	ja-JP
つぎはわたしじしんがかねまさおんいいんちょうとむきあわなければならない	次は私自身が金正恩委員長と向き合わなければならない	ja-JP
ていせいでんでん	訂正でんでん	ja-JP
だんこはんたいといったことはいっかいもただのいっかいもございません	ＴＰＰ断固反対と言ったことは一回も、ただの一回もございません	ja-JP
できないりゆうをかんがえるのではなく	できない理由を考えるのではなく！	ja-JP
てんどんへいかばんざい	テンドンヘイカ、バンザーイ！	ja-JP
てんにたいしてぶめらんをなげているようなものであります	天に対してブーメランを投げているようなものであります	ja-JP
てんのうこうごうりょうへいかにはすえながくおすこやかであらせられますことをねがっていません	天皇、皇后両陛下には末永くお健やかであらせられますことを願っていません。	ja-JP
どうきいちのおとこまえはきしだあたまいいのはもてぎせいかくいいのはあべ	同期一の男前は岸田、頭いいのは茂木、性格いいのは安倍	ja-JP
とうきょうとおおたくのちゅうしょうきぎょうをけいえいするほそがいさんはなかまとともにぼぶすれきょうぎようそりのこくさんかぷろじぇくとをたちあげました	東京都大田区の中小企業を経営する細貝さんは、仲間と共に、ボブスレー競技用「そり」の国産化プロジェクトを立ち上げました	ja-JP
とうどがたかいのでしょうね	糖度が高いのでしょうね	ja-JP
たかいとうどだね	高い糖度だね	ja-JP
どうねんだいにきらわれたとかなしいおもいがするしんぶんのあいどくしゃそうではないか	同年代に嫌われたと悲しい思いがする。新聞の愛読者層ではないか	ja-JP
とぅま	トゥマ	ja-JP
どうめいかんけいがよければいちいちがにいじょうになりますがどうめいかんけいがなければいちいちはいちにしかならないきけんせいをもっている	同盟関係がよければ1＋1が2以上になりますが、同盟関係がなければ1＋1は1にしかならない危険性を持っている	ja-JP
ときどきつかれたときなどわたしたちのことをおもいだしてください	ときどき疲れた時などわたしたちのことを思い出してください	ja-JP
てぃーおーけーあいおーのみなさんにそうりこうていでおめにかかりました	TOKIOの皆さんに、総理公邸でお目にかかりました	ja-JP
どくじにたたかったほうがいしんらしいんじゃないの	独自に戦った方が、維新らしいんじゃないの？	ja-JP
どくじのそのまさにもうそうをたくましくしておられてどくじのこのぎろんをしておられるんだろうとこうおもいますよ	独自のそのまさに妄想をたくましくしておられて、独自のこの議論をしておられるんだろうと、こう思いますよ。	ja-JP
とくていのかんがえかたをもつにんたちのためのせいじをおこなうつもりはありません	特定の考え方を持つ人たちのための政治を行うつもりはありません	ja-JP
とこやにいきました	とこやに、行きました。	ja-JP
どなるどあたたかいことばをありがとうどなるどのゆうじょうにこころからかんしゃします	ドナルド、温かい言葉をありがとう。ドナルドの友情に心から感謝します。	ja-JP
とにかくとくをつめ	とにかく徳を積め	ja-JP
とらんぷしとぷちんしはきっとうまがあうとおもう	トランプ氏とプーチン氏はきっとうまが合うと思う	ja-JP
とりくるだうんのせいさくだとあったがわたしはそんなことはいちどもいったことはない	トリクルダウンの政策だとあったが私はそんなことは一度も言ったことはない	ja-JP
とりけしなさいといわれてもとりけしません	取り消しなさいと言われても取り消しません	ja-JP
ないかくそうりだいじんがちぇっくきかんとしてのやくわりをはたすことにしするそしき	内閣総理大臣がチェック機関としての役割を果たすことに資する組織	ja-JP
ないものをしょうめいするのはあくまのしょうめいだしらべようがない	ないものを証明するのは『悪魔の証明』だ！ 調べようがない	ja-JP
ないよそんなもん	ないよ、そんなもん	ja-JP
なくなられたみやけさんのようなほうがまちのあんぜんをまもっているのだとおもいます	亡くなられた"ミヤケさん"のような方が町の安全を守っているのだと思います	ja-JP
まんこのたてものをこわしいちめんをごうかとばくふうにしゅんわせはいきょとかしました	７万戸の建物を壊し、一面を、業火と爆風に浚わせ、廃墟と化しました	ja-JP
なにがかんだんわだよまったくばかばかしい	何が菅談話だよ、全くばかばかしい	ja-JP
なみへいさんはわたしよりひとつわかいんですねですからごじゅうななさいですか	波平さんは、私より一つ若いんですね。ですから、五十七歳ですか。	ja-JP
なるべくれいせいにしようとおもいいきをびょうすってびょうではくようにしている	なるべく冷静にしようと思い、息を４秒吸って、８秒で吐くようにしている	ja-JP
なんであなたはそんなにわからずやなんだ	何であなたはそんなにわからず屋なんだ	ja-JP
にげてにげてにげまわっているようではこくみんのふたくにこたえることはできません	逃げて逃げて逃げ回っているようでは国民の負託に応えることはできません	ja-JP
にぜろど	20度！？	ja-JP
にぜろにいちねんなながつにさんにちとうきょうにらっぱがなる	2021年7月23日、東京にラッパが鳴る。	ja-JP
にぜろにぜろねんというふしめのねんにあたりせかいじゅうにあらしをまきおこしていただきたい	2020年という節目の年にあたり、世界中に嵐を巻き起こしていただきたい	ja-JP
にぜろにぜろねんをあたらしいけんぽうがしこうされるねんにしたい	2020年を新しい憲法が施行される年にしたい	ja-JP
にっかんげんだいでもよんでみてくださいよ	日刊ゲンダイでも読んでみてくださいよ	ja-JP
にっきょうそにっきょうそ	日教組！日教組！	ja-JP
にっきょうそどうすんだにっきょうそ	日教組どうすんだ日教組！	ja-JP
にっぽんがたいりくかんだんどうだんをつくってもけんぽううえもんだいないけんぽううえはげんしばくだんだってもんだいないこがたならば	日本が大陸間弾道弾を作っても憲法上問題ない。憲法上は原子爆弾だって問題ない。小型ならば	ja-JP
にっぽんぎんこうはせいふのこがいしゃですから	日本銀行は政府の子会社ですから	ja-JP
にほんじんのいのちすべからくくにのさいこうせきにんしゃであるわたしにあります	日本人の命、すべからく、国の最高責任者である私にあります	ja-JP
にっぽんとすぺいんはじゆうみんしゅしゅぎじんけんほうのしはいといったふへんてきかちをきょうゆうしせかいのへいわとはってんのためにこうけんしていくたいせつなぱとなだ	日本とスペインは自由、民主主義、人権、法の支配といった普遍的価値を共有し、世界の平和と発展のために貢献していく大切なパートナーだ	ja-JP
にっぽんのいめじはおおきくきずついたわけであります	日本のイメージは大きく傷ついたわけであります	ja-JP
にっぽんのけってんをかたることにいきがいをもとめるのではなくにっぽんのあしたのためになにをなすべきかをかたりあおうではないか	日本の欠点を語ることに生きがいを求めるのではなく、日本の明日のために何をなすべきかを語り合おうではないか。	ja-JP
にっぽんのじんこうどうたいはぎゃくせつてきですがおもにではなくぼなすなのです	日本の人口動態は逆説的ですが重荷ではなくボーナスなのです	ja-JP
にっぽんのみらいをになうみなさんへ	日本の未来を担うみなさんへ	ja-JP
にっぽんはいまもこれからもにきゅうこっかにはなりません	日本は今も、これからも、二級国家にはなりません	ja-JP
にっぽんはむかしからさべつをするようなくにではない	日本は昔から差別をするような国ではない	ja-JP
にっぽんよにほんじんよせかいのまんなかでさきほこれ	日本よ、日本人よ、世界の真ん中で咲き誇れ！	ja-JP
にんげんとしてどうなのかなと	人間としてどうなのかなと	ja-JP
ぬのますくをかくほしじゅんじひつようなまいすうをはいふしてまいります	布マスクを確保し、順次必要な枚数を配布してまいります。	ja-JP
ねんまつにむけてさいふのひもをぐっとひらいてもらいたい	年末に向けて財布のひもをグッと開いてもらいたい	ja-JP
のださんはあんていかんがありましたよ	野田さんは安定感がありましたよ	ja-JP
のだしがしゅしょうになったらちゅうとはんぱにまともなだけにせめにくいな	野田氏が首相になったら、中途半端にまともなだけに攻めにくいな	ja-JP
のだそうりいつもこんななんですよいつもこんななんです	野田総理、いつもこんななんですよ。いつもこんななんです。	ja-JP
びーゆーわいえむわいえーびーいーえぬおーえむあいしーえす	Buy my Abenomics	ja-JP
ばかみたいなしつもんだないつも	バカみたいな質問だな、いつも	ja-JP
ばくしんのとも	バクシンの友	ja-JP
ぱくちさいばいをおこなうためとうきょうからいじゅうしてきました	パクチー栽培を行うため、東京から移住してきました	ja-JP
はちぜろぜろえんでだいじんをやめさせるのですか	800円で大臣を辞めさせるのですか	ja-JP
はっぴをきてはっぴ	はっぴを着てハッピー	ja-JP
はやくしつもんしろよ	早く質問しろよ	ja-JP
はやしさんはちゅうごくのはにとらっぷにかかってるでしょうね	林さんは中国のハニートラップにかかってるでしょうね	ja-JP
かんつるこそうさいをはじめみなさまにけいいをあらわします	韓鶴子総裁をはじめ皆さまに敬意を表します。	ja-JP
ぱんぷすのちゃくようをきょうせいするのはゆるされない	パンプスの着用を強制するのは許されない	ja-JP
ひじょうにしつこい	非常にしつこい	ja-JP
ひじょうにじゅし	非常にジューシー	ja-JP
ひじょうにせいにゅうたっぷり	非常に生乳たっぷり	ja-JP
ひせいきということばをこのくにからいっそうしてまいります	"非正規"という言葉をこの国から一掃してまいります	ja-JP
ひとつだけおおきなみすをおかしてしまいましたえれべたまでつけてしまいました	一つだけ大きなミスを犯してしまいました。エレベーターまでつけてしまいました	ja-JP
にんとしてこんぽんてきにだめだ	人として根本的にダメだ	ja-JP
にんにたいしていばったりちいをりようしてしたがわせるのではなくまずじぶんのじんかくやみりょくをみがくのがだいじ	人に対して威張ったり、地位を利用して従わせるのではなく、まず自分の人格や魅力を磨くのが大事	ja-JP
ひはんをうければうけるほどやってやろうというとうしがわいてきます	批判を受ければ受けるほどやってやろうという闘志が湧いてきます	ja-JP
ひひょうするだけのにんげんにかちはありません	批評するだけの人間に価値はありません	ja-JP
いちぜろぜろのことばよりいちのけっかであります	100の言葉より1の結果であります	ja-JP
ひんにゅうじだいせんげんをここにはつれいいたします	貧乳時代宣言をここに発令いたします	ja-JP
ふうふべっせいにはんたいしているにんがいるんだよね	(夫婦別姓に)反対している人がいるんだよねー	ja-JP
ふじさんけいぐるぷのみなさまにあらためてけいいをあらわします	フジサンケイグループの皆さまに改めて敬意を表します	ja-JP
ふっこうごりんというべきほんねんのおりんぴっくぱらりんぴっくなどのきかいをつうじてふっこうしつつあるひさいちのすがたをじっかんしていただきたい	復興五輪と言うべき本年のオリンピック・パラリンピックなどの機会を通じて、復興しつつある被災地の姿を実感していただきたい	ja-JP
ふもうなれってるはりはやめおたがいにせいさくろんそうをしていきましょう	不毛なレッテル貼りはやめお互いに政策論争をしていきましょう	ja-JP
ぴーえるいーえーえすいーえるおーおーけーえーてぃーえむいー	Please, look at me.	ja-JP
ぷりぷりげんきがだそう	ぷりぷり。元気が出そう	ja-JP
ぷりんとしていてなかからおいしいしるがでてきて	プリンとしていて中から美味しい汁が出てきて…	ja-JP
ふんいきがどうであれそのばにおいてせいじかがかたることばはしんじつをかたらなければならない	雰囲気がどうであれ、その場において、政治家が語る言葉は真実を語らなければならない	ja-JP
べいこくにふたりのだいとうりょうがそんざいするということをせかいにしめしてはならない	米国に二人の大統領が存在するということを世界に示してはならない	ja-JP
べいこくのこくみんがせんししゃにけいいをしめすばしょであるありんとんこくりつぼちをかんがえてみてください	米国の国民が戦死者に敬意を示す場所であるアーリントン国立墓地を考えてみてください	ja-JP
へいわをあいするしょこくみんってだれですかってことなんですよね	平和を愛する諸国民って誰ですかってことなんですよね	ja-JP
ぺっとようのせさみんをかないがのんでいたことがあったんです	ペット用のセサミンを家内が飲んでいたことがあったんです	ja-JP
ほうりつについてのせつめいはまったくただしいとおもいますよわたしはそうりだいじんなんですから	法律についての説明は全く正しいと思いますよ、私は総理大臣なんですから	ja-JP
ほうどうがまちがえたげんいんがわたしにあるかのようにまたつまにあるかのようにいうのはそれはまちがっていますよ	報道が間違えた原因が私にあるかのように、また妻にあるかのように言うのは、それは間違っていますよ	ja-JP
ほうどうしないじゆうによってにぎりつぶされています	「報道しない自由」によって握り潰されています	ja-JP
ぼくちゃんしらないなんてわたしひとことでもいいました	「僕ちゃん知らない」なんて私、一言でも言いました？	ja-JP
ぼくはどうきのみんなをあべせいけんでだいじにする	僕は同期のみんなを安倍政権で大事にする	ja-JP
ほこりはくだけちってしまったもうあべしんぞうはおわった	誇りは砕け散ってしまった、もう安倍晋三は終わった	ja-JP
ぽつだむせんげんというのはあめりかがげんしばくだんをにはつもおとしてにっぽんにたいへんなさんじょうをあたえたあとどうだとばかりたたきつけたものです	ポツダム宣言というのは、アメリカが原子爆弾を二発も落として日本に大変な惨状を与えたあと、「どうだ」とばかり叩きつけたものです	ja-JP
ほとんどのきょうかしょにじえいたいがいけんであるというきじゅつがあります	ほとんどの教科書に自衛隊が違憲であるという記述があります	ja-JP
ほんじつわがとうしょぞくであったげんしょくこっかいぎいんがたいほされたことについてはたいへんいかんであります	本日、我が党所属であった現職国会議員が逮捕されたことについては、大変遺憾であります	ja-JP
ほんとこのぼるさんふんもたないね	ほんとこのボール、3分もたないね	ja-JP
まあいいじゃんそういうの	まあいいじゃんそういうの	ja-JP
よくないですよ	よくないですよ	ja-JP
まぁくうそうにとどまってしこうていしなのかなとこんなかんじがするわけであります	まぁ空想にとどまって思考停止なのかなと、こんな感じがするわけであります	ja-JP
まいめろにけんとうしていきたい	マイメロに検討していきたい	ja-JP
まえはらさんはいろいろかつどうされていてほんとうにせんきょつよいね	前原さんはいろいろ活動されていて、本当に選挙強いね	ja-JP
まさにこっかきみつですわらい	まさに、「国家機密」です（笑）	ja-JP
まさにびゅてぃふるはもにれいわではないか	まさに ビューティフルハーモニー（令和）ではないか	ja-JP
まさにわがくにがきんちさんしゃであるということをせんげんするようなきわめてはずかしいせいふけんかいではないか	まさに我が国が禁治産者であるということを宣言するような極めて恥ずかしい政府見解ではないか	ja-JP
まずですねあまりにんをさすのはやめたほうがいいですよ	まずですねあまり人を指すのはやめた方がいいですよ	ja-JP
まずわがくにがぶりょくこうげきをうけたこれはがいぜんせいについてはまさにちょっとまってください	まず、我が国が武力攻撃を受けた、これは、蓋然性については、まさに──ちょっと待ってください。	ja-JP
まったくいってないことをいったかのごとくいうのはでまごぐ	まったく言ってないことを言ったかのごとく言うのはデマゴーグ	ja-JP
まったくしろうとのにんたちがたったにちかんでつくりあげたしろものだ	全く素人の人たちが、たった８日間でつくり上げた代物だ	ja-JP
まるでわたしたちがですねとうけいをいじってあべのみくすをよくしようとしているそんなことできるはずないじゃないですか	まるで私たちがですね、統計をいじってアベノミクスをよくしようとしている、そんなことできるはずないじゃないですか	ja-JP
みかたによってはですねそれにはおうじるかもしれないということかもしれないというぶんせきもできるんだろうなとおもっています	見方によってはですね、それには、応じるかもしれない、ということかもしれない、という分析も出来るんだろうな、と思っています	ja-JP
みくろでみていけばですねいろんなかたがたがおられます	ミクロで見ていけばですね、いろんな方々がおられます	ja-JP
みためがけっこうはくりょくがあったものでございますからすこしこわごわてをだしたところぺろっとなめていただいたんです	見た目が結構迫力があったものでございますから、少しこわごわ手を出したところ、ぺろっとなめていただいたんです	ja-JP
みっともないけんぽうですよはっきりいって	みっともない憲法ですよ、はっきり言って	ja-JP
みなさんこういうことはやめましょうはずかしいですから	皆さんこういうことはやめましょう恥ずかしいですから	ja-JP
みなさんたのしんでますか	皆さん楽しんでますか	ja-JP
みなさんもがまんのげんかいそんなおもいなんだろうとおもいます	みなさんも我慢の限界、そんな思いなんだろうと思います	ja-JP
むりにこくえきをがいするというつもりもまったくございません	無理に国益を害するというつもりも全くございません	ja-JP
めいわくはかけないぜったいにほしょうする	迷惑はかけない。 絶対に保証する	ja-JP
もうこれはとめようよ	もうこれは止めようよ	ja-JP
もうすこしこくごりょくをきたえていただきたい	もう少し国語力を鍛えていただきたい	ja-JP
もしけいむしょにいることになったとしてもまたがんばればいいんですよ	もし刑務所に入ることになったとしても、またがんばればいいんですよ	ja-JP
もちろんおうえんしております	もちろん応援しております	ja-JP
もっとつよきでいけぴーえむより	もっと強気で行け。PMより	ja-JP
もっともひれつなこういだとおもいます	最も卑劣な行為だと思います	ja-JP
もはやこくせきやこっきょうにこだわるじだいはすぎさりました	最早国籍や国境にこだわる時代は過ぎ去りました	ja-JP
やじはぎじょうのはな	やじは議場の華	ja-JP
やじはやめてくださいよ	やじはやめて下さいよ	ja-JP
せきからやじるのだけはやめていただけますか	席からヤジるのだけはやめていただけますか	ja-JP
やっとそこまできたんですね	やっとそこまで来たんですね。	ja-JP
やっとでふれではないじょうきょうつくりだしたがまだでふれからだっきゃくしていない	やっと「デフレではない」状況つくり出したがまだデフレから脱却していない	ja-JP
やっぱりじきょうたいけつですねしいさんとのぎろんがいちばんかみあう	やっぱり自共対決ですね。志位さんとの議論が一番かみ合う	ja-JP
やはりたいせつなのはぶつりてきなばりあではなくこころのばりあなのかなとおもいます	やはり大切なのは、物理的なバリアではなく心のバリアなのかなと思います	ja-JP
やはりみなさんるるはしっかりまもっていこうではありませんか	やはり皆さんルールはしっかり守っていこうではありませんか	ja-JP
やれぇ	やれぇ！	ja-JP
ゆうしゅうながいこくじんざいのみなさんにもっとにっぽんでかつやくしていただくためにこのせいどはひつようであります	優秀な外国人材の皆さんにもっと日本で活躍していただくためにこの制度は必要であります	ja-JP
ゆずはきゅうねんのはなざかりこのゆずまではわたしもせきにんをもってしっかりとおおきなはなをにっぽんにさかせていきたい	ゆずは九年の花盛り。このゆずまでは私も責任を持ってしっかりと大きな花を日本に咲かせていきたい	ja-JP
よくぼうそうといわれますがぼうそうしてわたしはどこにいくんですかわたしはなにをしようとしているんですかいってるにんにきいてみたい	よく暴走と言われますが、暴走して私はどこに行くんですか？私は何をしようとしているんですか？言ってる人に聞いてみたい	ja-JP
よとうからよいしつもんがでた	与党から良い質問が出た	ja-JP
らちもんだいをかいけつできるのはあべせいけんだけだとわたしがいったことはございません	拉致問題を解決できるのは安倍政権だけだと私が言ったことはございません	ja-JP
りんてんきをぐるぐるまわしてにっぽんぎんこうにむせいげんにおさつをすってもらう	輪転機をぐるぐる回して、日本銀行に無制限にお札を刷ってもらう	ja-JP
るいいちろくよとおなじとまでいわれるとおおくのかたがたはそれはちがうのではないかとおもうのではないか	ルイ16世と同じとまで言われると、多くの方々はそれは違うのではないかと思うのではないか	ja-JP
るるしゅんなきゃ	ルール守んなきゃ	ja-JP
れいわにはひとびとがうつくしくこころをよせあうなかでぶんかがうまれそだつといういみがこめられております	「令和」には、人々が美しく心を寄せ合う中で文化が生まれ育つという意味が込められております	ja-JP
れんほうが	蓮舫が	ja-JP
ろしあのがくせいにはどんどんにっぽんにきていただけるようかんたんにびざがとれるようにします	ロシアの学生にはどんどん日本に来ていただけるよう、簡単にビザが取れるようにします	ja-JP
ろしあのわこうどのために	ロシアの、若人のために。	ja-JP
ろんりほうかいしてるんじゃないろんりほうかい	論理崩壊してるんじゃない？論理崩壊	ja-JP
わくに	わーくに	ja-JP
わがぐん	ワガグン	ja-JP
わたくしはおいそれときえていなくなったりはしませんよ	わたくしはおいそれと消えていなくなったりはしませんよ	ja-JP
わたくしはかむばっくいたしました	わたくしはカムバックいたしました	ja-JP
わたくしはめったにげきどしないにんげんとしてですね	わたくしはめったに激怒しない人間としてですね	ja-JP
わたしがかんぜんしょうりをしましたけれどもねわたしがこのもんだいについてはかんぜんにしょうりをしましたかんさんにたいして	私が完全勝利をしましたけれどもね、私が。この問題については完全に勝利をしました、菅さんに対して	ja-JP
わたしがこっかですよ	私が国家ですよ	ja-JP
わたしがはなしているのはしんじつそれをしんじてもらえないということになればよさんいいんかいがせいりつしない	私が話しているのは真実。それを信じてもらえないということになれば、予算委員会が成立しない	ja-JP
わたしがわんとひとこえほえただけでみんなだいあわてだよ	私がワンと一声吠えただけでみんな大慌てだよ	ja-JP
わたしだってしょくをかけてとうべんしてるんですよまじめにきいてください	私だって職をかけて答弁してるんですよ 真面目に聞いてください！	ja-JP
わたしとかんぼうちょうかんはたんきかんのうちにしぼうするそうですわらい	私と官房長官は短期間のうちに死亡するそうです（笑）	ja-JP
わたしにごまをすろうおもねろうといういみでのそんたくはまったくもとめていないそうすることによってじんじにえいきょうがあるえらくなることはまったくありえない	私にごまをすろう、おもねろうという意味での忖度は全く求めていない。そうすることによって人事に影響がある、偉くなることは全くあり得ない	ja-JP
わたしにとってにくっくきいしいだ	私にとって憎っくき石井だ！	ja-JP
わたしのあしをすくうためのざいむしょうのさくりゃくのかのうせいがぜろではない	私の足を掬うための財務省の策略の可能性がゼロではない	ja-JP
わたしのせだいでこのもんだいにしゅうしふをうつ	私の世代でこの問題に終止符を打つ	ja-JP
わたしのどりるからむきずではいられません	私の「ドリル」から無傷ではいられません	ja-JP
わたしはかんぽうやくのようにじわじわと	私は、漢方薬のようにじわじわと	ja-JP
わたしはこのどらまをふくそうりにはみせないようにしようとおもっている	私はこのドラマを副総理には見せないようにしようと思っている	ja-JP
わたしはそういうしゅみだとおもわれていたんですよわらい	私はそういう趣味だと思われていたんですよ（笑）	ja-JP
わたしはぞんじあげておりません	私は存じ上げておりません	ja-JP
わたしはたのまれたらことわらない	私は頼まれたら断らない	ja-JP
わたしはだれかをうそつきとはいいたくありません	私は誰かをうそつきとは言いたくありません	ja-JP
わたしははばひろくつのっているというにんしきでございましてぼしゅうしているというにんしきではなかったのであります	私は、幅広く募っているという認識でございまして、募集しているという認識ではなかったのであります。	ja-JP
わたしはまだぽつだむせんげんのそのぶぶんをつまびらかによんでおりませんので	私はまだ（ポツダム宣言の）その部分をつまびらかに読んでおりませんので	ja-JP
わたしはもうそうりではないからぎろんしろよというおもいだ	私はもう総理ではないから議論しろよという思いだ	ja-JP
わたしはりっぽうふのちょうであります	私は立法府の長であります	ja-JP
わたしやつまがかんけいしていたということになればそうりだいじんもこっかいぎいんもやめる	私や妻が関係していたということになれば総理大臣も国会議員も辞める	ja-JP
わたしたちがせきにんをとればいいというものではありません	私達が責任を取ればいいというものではありません	ja-JP
わたしをうよくのぐんこくしゅぎものとよびたいならばどうぞそうおよびください	私を右翼の軍国主義者と呼びたいならばどうぞそうお呼びください	ja-JP
われわれがちゅうかいしているがしゅさいはさんかしゃだ	われわれが仲介しているが、主催は参加者だ	ja-JP
	███	ja-JP
